####################################################NN###
####################################################NN###
####################################################..###
###################........#########################..###
##############........##############################..###
###########..........###############################..###
###########........#################################..###
###########.......##################################..###
##############..####################################..###
##############...###################################..###
##############...###################################..###
###############.......................................###
###############.......................................###
#########################################################
#########################################################
#########################################################
#########################################################
#########################################################
#########################################################
#########################################################
#########################################################
#########################################################
#########################################################
#########################################################
#########################################################
#########################################################
#########################################################

